 Outkast: Hey Ya!
 Gorillaz: Feel Good, Inc
 Missy Elliot: Get Ur Freak On
 Gnarls Barkley: Crazy
 *NSYNC: Bye Bye Bye
 Nelly: Hot In Herrre
 Beyonce (feat Jay-Z): Crazy In Love
 Kelly Clarkson: Since U Been Gone
 Dixie Chicks: Not Ready To Make Nice
 Alicia Keys: Fallin'
 Modest Mouse: Float On
 Jason Mraz: The Remedy (I Won't Worry)
 The Postal Service: Such Great Heights
 U Beautiful Day
 Yeah Yeah Yeahs: Maps
 Feist: 4
 Keane: Somewhere Only We Know
 The Killers: Somebody Told Me
 Kylie Minogue: I Can't Get You Out of My Head
 Ok Go: Here It Goes Again
 Katy Perry: I Kissed a Girl
 Snow Patrol: Chocolate
 Regina Spektor: Fidelity
 Train: Drops of Jupiter (Tell Me)
 KT Tunstall: Black Horse and the Cherry Tree
 Kanye West: Jesus Walks
 Lily Allen: Smile
 Black Eyed Peas: Where Is the Love
 Mary J Blige: Family Affair
 Death Cab For Cutie: I Will Follow You Into the Dark
 Eminem: Lose Yourself
 Fountains of Wayne: Stacey's Mom
 David Gray: Babylon
 Green Day: Wake Me Up When September Ends
 Guster: Careful
 Jimmy Eat World: The Middle
 Leona Lewis: Bleeding Love
 Maroon  Makes Me Wonder
 John Mayer: No Such Thing
 MGMT: Electric Feel
 Peter Bjorn and John: Young Folks
 Gwen Stefani: Hollaback Girl
 The Strokes: Last Nite
 Glen Hansard & Marketa Iglova: Falling Slowly
 Justin Timberlake: SexyBack
 Rufus Wainwright: Want
 Amy Winehouse: Rehab
  Cent: In Da Club
 Ryan Adams: New York, New York
 Fiona Apple: Extraordinary Machine
 Arcade Fire: Wake Up
 Natasha Bedingfield: Unwritten
 Coldplay: Clocks
 Dandy Warhols: We Used To Be Friends
 Fall Out Boy: Thnks Fr Th Mmrs
 Flaming Lips: Fight Test
 Ben Folds: You Don't Know Me
 Franz Ferdinand: Take Me Out
 Frou Frou: Let Go
 Jay-Z:  Problems
 Jack Johnson: Flake
 Junior Senior: Move Your Feet
 Kings of Leon: Sex On Fire
 Lady Gaga: Poker Face
 LCD Soundsystem: Daft Punk Is Playing At My House
 MIMS: This Is Why I'm Hot
 Nada Surf: Always Love
 Phoenix: Lisztomania
 Rihanna feat Jay-Z: Umbrella
 Rilo Kiley: Portions For Foxes
 Andy Samberg's SNL Digital Shorts
 The Shins: Caring Is Creepy
 Britney Spears: Toxic
 Spoon: I Turn My Camera On
 Ting Tings: Shut Up and Let Me Go
 Usher feat Ludacris & L'il Jon: Yeah!
 Vicious Vicious: Shake That Ass On the Dancefloor
 White Stripes: Seven Nation Army
 X-Press feat David Byrne: Lazy
 "Weird Al" Yankovic: White 'N' Nerdy
 Daniel Powter: Bad Day
 The All-American Rejects: Gives You Hell
 Aqualung: Brighter Than Sunshine
 India Arie: Video
 Matt Pond PA: Halloween
 MIA: Paper Planes
 My Morning Jacket: Golden
 Bloc Party: Banquet
 Loretta Lynn: Portland, Oregon
 New Pornographers: The Bleeding Heart Show
 Ray LaMontagne: You Are the Best Thing
 Owl City: Fireflies
 AR Rahman: Jai Ho
 Santogold: LES Artistes
 Scissor Sisters: Take Your Mama
 Jill Scott: Golden
 Shakira: Whenever, Wherever
 Soulja Boy: Crank That (Soulja Boy)
 Sufjan Stevens: The Man of Metropolis Steals Our Hearts
 Yellowcard: Ocean Avenue